24 14
~~~~~~~~~~~•~~~~~~~~~~~~
~~~•••••~~~•~~~~~~~~~~~~
••••~~~•••••~~~~~~~~~~~~
~~~~~~~~~~~••••••••~~~~~
~~~~~~~~~~~•~~~~~~•~~~~~
~~~~~~~~~~~•~~~~~~•~~~~~
~~~~~~~~~~~••~~~~~•~~~~~
~~~~~~~~~~~~•~~••••~~~~~
~~~~~~~~~~~~•~~•~~~~~~~~
~~~~~~~~•••••~~•~~~~~~~~
~~~~~~~••~~•~~~•~~~~~~~~
~~@•••••~~~•••••~~~~~~~~
~~~~~~~~~~~~~~~~~~~~~~~~
~~~~~~~~~~~~~~~~~~~~~~~~