14 24
•••••••••••••••••••~••~•
•••••••••••••••••••~~~~•
••••••••••••••••~~~~••••
•••••~~~~~~~~~~~~••~••••
•••••~•••~••••••~••~••••
••~~~~•••~••••~~~~~~••••
••~••~•••~••••~•~•••••••
••~••~~~~~~~~~~~~•••••••
••~~~~•••~•~•••~••••••••
•••~•••••~~~•••~••••••••
•••~•••••••~•••~••••••••
•••@•••••••~~~~~••••••••
••••••••••••••••••••••••
••••••••••••••••••••••••