24 14
~~~~~~~~~~~~~~~~~~~•~~•~
~~~~~~~~~~~~~~~~~~~••••~
~~~~~~~~~~~~~~~~••••~~~~
~~~~~••••••••••••~~•~~~~
~~~~~•~~~•~~~~~~•~~•~~~~
~~••••~~~•~~~~••••••~~~~
~~•~~•~~~•~~~~•~•~~~~~~~
~~•~~••••••••••••~~~~~~~
~~••••~~~•~•~~~•~~~~~~~~
~~~•~~~~~•••~~~•~~~~~~~~
~~~•~~~~~~~•~~~•~~~~~~~~
~~~@~~~~~~~•••••~~~~~~~~
~~~~~~~~~~~~~~~~~~~~~~~~
~~~~~~~~~~~~~~~~~~~~~~~~