14 24
••••••••••••~•••••••••••
••••••••••••~•••••••••••
••••••••••••~•••••••••••
•••@•••••~~~~••••~~~~~••
•••~•••••~•••••••~•••~••
•••~•••••~•••••••~•••~••
•••~•••••~•••••••~•••~••
•••~•••••~•••••••~•••~••
•••~•••••~•••••••~•••~••
•••~•••••~•••••••~•••~••
•••~••~~~~~~~~~~~~•••~~~
•••~~~~•••••••••••••••••
••••••••••••••••••••••••
••••••••••••••••••••••••