24 14
•••••••••••~••••••••••••
•••~~~~~•••~••••••••••••
~~~~•••~~~~~••••••••••••
•••••••••••~~~~~~~~•••••
•••••••••••~••••••~•••••
•••••••••••~••••••~•••••
•••••••••••~~•••••~•••••
••••••••••••~••~~~~•••••
••••••••••••~••~••••••••
••••••••~~~~~••~••••••••
•••••••~~••~•••~••••••••
••@~~~~~•••~~~~~••••••••
••••••••••••••••••••••••
••••••••••••••••••••••••