24 14
~~~~~~~~~~~~•~~~~~~~~~~~
~~~~~~~~~~~~•~~~~~~~~~~~
~~~~~~~~~~~~•~~~~~~~~~~~
~~~@~~~~~••••~~~~•••••~~
~~~•~~~~~•~~~~~~~•~~~•~~
~~~•~~~~~•~~~~~~~•~~~•~~
~~~•~~~~~•~~~~~~~•~~~•~~
~~~•~~~~~•~~~~~~~•~~~•~~
~~~•~~~~~•~~~~~~~•~~~•~~
~~~•~~~~~•~~~~~~~•~~~•~~
~~~•~~••••••••••••~~~•••
~~~••••~~~~~~~~~~~~~~~~~
~~~~~~~~~~~~~~~~~~~~~~~~
~~~~~~~~~~~~~~~~~~~~~~~~